
g = sché
j = schí
q = qü
u = ü 
v = weh
w = duble weh
y = i grek

Et vous? = und du?
qu'est ceque c'est? = was ist das?
voiture = fahrzeug
nom de famille = familiennamen
je ne comprä pa = ich verstehe nicht
kosché = check (checkbox)
est-ce que c'est ..? = ist das ..?
oui, c'est un / une ..
no, ce n'est pas un / une ..
mem chose = same thing
C'est qui? = Qui est_ce?
combien = how many
ou = oder
und = et
me = aber
ce tu = that's it
meh pour le vocabulair, ce n'est pas encoure ca. = aber das vokabular ist noch nicht so gut
pour que tu apprenü plus vite = 
je (ne) veux plus voluar = ich will (nicht) mehr
devoirs = hausaufgabe
ils sont melange = they are all mixed up
votre = ihr/euer (höflichkeitsform)
wer =
wie =
was = 
wieso =
weshalb =
warum = pour qua
wohin =
aussi = auch
comment = 
compte = zählen
pouvoir = 
chiffres = ziffern
fois = mal (z.b. 2 * 2)
egal = gleich

bleu, vert, blanche, jaune, rouge, noire

le = löh, une = ün; feminoa
la, un = ah; masculin

je = ich
tu = du
il/elle = er/sie
es gibt kein "es"/neutrum. alles ist entweder f oder m.
nous = wir
vous = ihr
ils/elles = sie; elles = z.b. gruppe von weibl. dingen (zb. frauen); sobald mind. 1 masculine dabei ist, wird's männlich: ils.

je 			suis
tu 			es
il/elle 	est
nous 		nous sommes
vous 		vous etes
ils/elles 	sont

je 			m'appelle
tu 			t'appelle
il/elle 	s'appelle
nous 		nous appellans
vous 		vous appelez
ils/elles 	s'appelant

lunedi, mardi, mercredi, jeudi, vanredi, samedi, dimanche

country names:
ends with e = la (fem.)
ends with s = les (plural)
starts with vocal = l'
otherwise le (mask.)
